らる	見る	名詞	
らる	被る	名詞	
らる	為る	名詞	
らる	所る	名詞	
お	於	名詞	
う	乎	名詞	
こ	于	名詞	
きょうこうけん	教皇権	名詞	
アントニウス	（◜◡‾）/ｱﾝﾄﾆｰ	名詞	
ほしゅう	捕囚	名詞	
りょうほう	領邦	名詞	
せつびし	接尾子	名詞	
なぽれおん	(Z(:^P	名詞	
やんしゃお	仰韶	名詞	
ろんしゃん	竜山	名詞	
ちょうこう	長江	名詞	
さいとう	彩陶	名詞	
さいもんどき	彩文土器	名詞	
こくとう	黒陶	名詞	
まけん	磨研	名詞	
はいとう	灰陶	名詞	
かい	華夷	名詞	
そうほう	宗法	名詞	
けんじゅう	犬戎	名詞	
う	禹	名詞	
こうけい	鎬京	名詞	
7ゆう	七雄	名詞	
しゅんしゅう	春秋	名詞	
しょうおう	商鞅	名詞	
かんよう	咸陽	名詞	
ろこう	呂后	名詞	
りょち	呂雉	名詞	
しょうめい	召命	名詞	
ででで	出、出～～ｗｗｗｗｗ奴～ｗｗｗｗｗｗｗ三(^o^)ノ	名詞	
かんけつば	汗血馬	名詞	
だいげっし	大月氏	名詞	
りこうり	李広利	名詞	
こうし	交趾	名詞	
ごしゅせん	五銖銭	名詞	
こじん	胡人	名詞	
いてきじゅうばん	夷狄戎蛮	名詞	
こかんやぜんう	呼韓邪単于	名詞	
ぜんう	単于	名詞	
せきび	赤眉	名詞	
かんのわのなのこくおう	漢委奴国王	名詞	
とうこのきん	党錮の禁	名詞	官吏がとじこめ
かんいどこくおう	漢委奴国王	名詞	
けつ	羯	名詞	五湖
てい	氐	名詞	チベット系の北方民族にして五湖のひとつ
きょう	羌	名詞	チベット系の北方民族にして五湖のひとつ
たくばつ	拓跋	名詞	北魏を建てた鮮卑
とっけつ	突厥	名詞	トルコ系民族
りゅうそう	劉宋	名詞	
ひすい	淝水	名詞	前秦と東晋の戦い
うんこう	雲崗	名詞	
じゅうぜん	柔然	名詞	
せいしん	西晋	名詞	
けんきょう	祆教	名詞	
くようだつ	孔穎達	名詞	
ぶいのか	武韋の禍	名詞	
そくてんぶこう	則天武后	名詞	
かいほう	開封	名詞	
せんえん	澶淵	名詞	
せいせい	西征	名詞	
こうぶてい	洪武帝	名詞	
こうきんのらん	紅巾の乱	名詞	
こほん	公行	名詞	
こうけんせいせい	康乾盛世	名詞	
とびひ	飛び杼	名詞	
きょうゆう	郷勇	名詞	
さんたんげん	三人称単数現在形	名詞	
さんたんげん	三単現	名詞	
しゅうおんらい	周 恩来	名詞	
や	乎	名詞	
こ	乎	名詞	
しゅこう	珠江	名詞	
どうていこ	洞庭湖	名詞	
じゅうごのせい	什伍の制	名詞	
りんし	臨淄	名詞	
